-- HUMAN RESOURCE MACHINE PROGRAM --

a:
    INBOX   
    COPYTO   0
    ADD      0
    COPYTO   0
    ADD      0
    COPYTO   0
    ADD      0
    COPYTO   0
    ADD      0
    ADD      0
    ADD      0
    ADD      0
    OUTBOX  
    JUMP     a


